Основные операторы SQL (наименьшая единица)

Data Definition Language (DDL) - группа операторов определения данных
create - создание новых объектов БД
alte - изменение существующих объектов
drop - удаление объектов

Data Manipulation Language (DML) - группа операторов для манипуляции с данными
insert - добавление новых данных
update - изменение 
delete - удаление
select - выборка 

Data Control Language (DCL) - операторы определения доступа к данным
grant - предоставить права на объект БД 
revoke -  отозвать у пользователя права на объект
deny - запрет на объект, имеет более высокий приориетет, чем grant

Transaction Control Language (TCL) - группа операторов для управления транзакциями
Транзакция - набор команд или инструкций который выполняются как единый блок
begin transaction - определяет начало транзакции
commit transaction - применяет транзакцию, конечная точка
rollback transaction - откатывает все изменения транзакции 
save transaction - устанавливает промежуточную точку сохранения внутри транзакции


Основные компоненты СУБД
Storage engine - подсистема постоянного хранения данных
Query parser - парсер и транслятор запросов 
Query optimizer - оптимизатор запросов 
Query executoe - подсистема выполнения 
Buffer cache -  подсистемы кэширования данных 


Подключение к СУБД
ODBC (open DB connectivity)
программный интерфейс доступа к БД

JDBC (java DB donnectivity)
==, только в среде java











































